TILEMAP
4 4							-- Player position
16 16 							-- Size of tile map in tiles
32 32 							      -- Tile size & block size
images/textures.png 	-- Tilesheet
13 20								-- Number of tiles in tilesheet
65 65 65 67 65 65 65 65 65 65 65 66 97 97 64 65 
65 65 65 65 65 67 65 65 78 78 78 79 97 97 64 65 
65 65 78 78 78 78 78 79 51 52 52 53 97 97 64 65 
65 66 51 52 53 57 51 53 77 78 78 79 97 97 64 65 
78 79 64 65 66 111 77 79 57 97 97 97 97 98 64 65 
97 97 77 78 79 97 97 85 0 84 0 84 97 97 64 65 
97 97 220 220 220 97 97 0 0 0 0 0 84 51 65 67 
98 97 72 0 0 0 84 85 0 0 0 0 71 77 78 78 
97 97 97 85 0 0 0 0 0 259 71 97 97 97 97 0 
97 85 0 0 0 0 0 0 0 260 84 97 97 97 0 0 
97 0 0 0 72 97 72 0 0 0 0 0 97 97 0 0 
97 0 71 97 97 111 97 0 0 0 0 71 97 85 0 0 
52 52 53 97 97 97 97 97 72 0 0 97 98 97 40 0 
65 65 65 52 52 52 53 97 97 97 97 111 97 97 51 52 
65 67 65 65 65 65 66 84 97 97 51 52 52 52 65 65 
65 65 65 65 67 65 66 0 0 84 64 65 65 65 67 65

0 0 0 0 0 0 0 0 0 0 0 0 0 0 0 0
0 0 0 0 0 0 0 0 0 0 0 0 0 0 0 0
0 0 0 0 0 0 0 0 0 0 0 0 0 0 0 0
0 0 0 0 0 0 0 0 0 0 0 0 0 0 0 0
0 0 0 0 0 0 0 0 0 0 0 0 0 0 0 0
0 0 0 0 0 0 0 0 0 0 0 0 0 0 0 0
0 0 0 0 0 0 0 0 0 0 0 0 0 0 0 0
0 0 0 0 0 0 0 0 0 0 0 0 0 0 0 0
0 0 0 0 0 0 0 0 0 0 0 0 0 0 0 0
0 0 0 0 0 0 0 0 0 0 0 0 0 0 0 0
0 0 0 0 0 0 0 0 0 0 0 0 0 0 0 0
0 0 0 0 0 0 0 0 0 0 0 0 0 0 0 0
0 0 0 0 0 0 0 0 0 0 0 0 0 0 0 0
0 0 0 0 0 0 0 0 0 0 0 0 0 0 0 0
0 0 0 0 0 0 0 0 0 0 0 0 0 0 0 0
0 0 0 0 0 0 0 0 0 0 0 0 0 0 0 0
