TILEMAP
2 12							-- Player position
16 16 							-- Size of tile map in tiles
32 32 							      -- Tile size & block size
images/textures.png 	-- Tilesheet
16 32								-- Number of tiles in tilesheet
34 50 51 0 0 0 33 50 50 50 50 50 50 50 34 34 
35 0 0 0 0 0 55 65 66 0 0 0 0 0 33 34 
51 0 0 0 0 0 71 81 82 0 0 0 0 0 33 34 
0 0 0 0 0 0 0 0 0 0 0 0 0 0 33 36 
0 0 0 0 0 0 0 0 0 0 0 0 0 0 33 34 
0 0 0 0 0 0 0 0 0 0 0 0 0 0 33 34 
0 0 0 0 0 0 0 0 0 0 0 0 0 0 49 50 
0 0 0 0 0 0 0 0 0 0 0 0 0 0 0 0 
0 0 0 0 0 0 0 0 0 0 0 0 0 0 0 0 
0 0 0 0 0 0 0 0 0 0 0 0 0 0 0 0 
0 0 0 0 0 0 0 0 0 0 0 0 0 0 0 0 
0 0 0 0 0 0 0 0 0 0 0 0 0 0 0 0 
0 0 0 0 0 0 225 225 225 0 0 0 0 0 0 0 
225 225 23 225 225 225 17 18 19 0 0 0 145 145 0 0 
18 18 18 18 18 19 33 36 35 225 225 225 23 23 225 225 
34 36 34 34 34 35 33 34 35 17 18 18 18 18 18 18 

0 0 0 0 0 0 0 0 0 0 0 0 0 0 0 0 
0 72 72 0 0 0 0 0 0 72 72 72 72 72 0 0 
0 72 41 0 0 0 0 0 0 0 73 72 0 0 0 0 
72 72 89 57 0 0 0 0 0 0 72 72 0 0 0 0 
72 72 72 0 0 0 0 0 0 0 72 72 72 0 0 0 
72 73 72 0 0 0 0 0 0 0 40 72 0 0 0 0 
72 72 72 41 0 0 0 0 0 40 72 73 0 0 0 0 
72 72 72 72 89 57 0 0 0 56 72 72 74 0 0 72 
72 57 0 0 56 0 0 0 0 0 73 56 57 0 40 72 
72 0 0 0 0 0 0 0 0 0 72 0 0 0 72 72 
73 57 0 0 0 0 0 0 0 40 89 57 0 0 72 73 
57 0 0 0 0 0 0 0 0 0 56 0 0 0 72 57 
0 0 0 0 0 0 0 0 0 0 0 0 0 0 56 40 
0 0 0 0 0 0 0 0 0 0 0 0 0 0 0 56 
0 0 0 0 0 0 0 0 0 0 0 0 0 0 0 0 
0 0 0 0 0 0 0 0 0 0 0 0 0 0 0 0 

2
0 2
4 4
8 4
1 1
7.5 1.5