TILEMAP
1 13							-- Player position
16 16 							-- Size of tile map in tiles
32 32 							      -- Tile size & block size
images/textures.png 	-- Tilesheet
16 32								-- Number of tiles in tilesheet
34 34 35 0 0 0 0 33 34 50 50 50 50 34 36 34 
34 36 35 0 0 0 0 49 51 0 0 0 0 49 50 34 
34 34 35 0 0 0 0 23 0 0 0 0 0 0 0 49 
34 34 35 0 0 0 0 23 0 0 0 0 0 0 0 0 
34 34 35 39 0 0 0 23 0 0 0 0 0 0 0 0 
36 34 35 71 0 0 0 0 0 0 0 0 0 0 0 0 
50 50 51 23 0 0 0 0 0 0 0 0 0 39 0 0 
21 21 21 22 225 225 0 0 0 0 0 0 225 55 0 0 
0 0 0 20 22 23 0 0 0 0 0 0 23 55 0 0 
0 0 0 0 0 0 0 0 0 0 0 0 0 71 0 0 
0 0 0 0 0 0 0 0 0 0 0 0 0 0 0 0 
0 0 0 0 0 0 0 0 0 0 0 0 0 0 0 0 
0 0 0 0 0 0 0 0 0 0 0 0 0 0 0 0 
0 0 0 0 0 0 0 0 0 0 0 0 0 0 0 0 
0 39 0 0 0 305 305 0 0 0 305 305 0 0 0 0 
0 55 0 0 0 0 0 0 0 0 0 0 0 0 0 0 

0 0 0 72 72 72 72 0 0 0 0 0 0 0 0 0 
0 0 0 72 73 72 72 0 0 73 72 57 0 0 0 0 
0 0 0 72 72 72 72 0 72 57 56 0 0 0 56 0 
0 0 0 72 57 0 72 0 74 0 0 0 0 0 0 0 
0 0 0 0 0 0 56 0 57 0 0 0 0 0 0 0 
0 0 0 0 0 0 0 57 0 0 0 0 0 0 0 40 
0 0 0 0 0 0 0 0 0 0 0 0 0 0 72 72 
0 0 0 0 0 0 0 0 0 0 0 0 0 0 72 73 
72 72 72 0 0 0 0 0 0 0 0 0 0 0 72 72 
72 73 89 57 56 0 0 0 0 0 0 0 56 0 89 72 
72 72 72 0 0 0 0 0 0 0 0 0 0 56 72 72 
72 57 56 0 0 0 0 0 0 0 0 0 0 0 72 56 
56 0 0 0 0 0 0 0 0 0 0 0 0 56 72 0 
0 0 0 0 0 0 0 0 0 0 0 0 0 0 57 0 
0 0 41 0 0 0 0 0 0 0 0 0 0 0 0 0 
40 0 73 0 0 0 0 0 0 0 0 0 0 0 0 0 

0