TILEMAP
16 16 							-- Size of tile map in tiles
32 32 							      -- Tile size & block size
images/celeste.png 	-- Tilesheet
16 32								-- Number of tiles in tilesheet
34 36 34 34 34 35 0 0 0 0 33 34 36 34 34 34 
34 34 36 34 50 51 0 0 0 0 49 50 34 34 36 34 
34 34 50 51 0 0 0 0 0 0 0 0 49 50 34 34 
36 35 225 0 0 0 0 0 0 242 241 242 0 225 33 34 
34 35 225 0 0 0 0 0 0 0 0 0 0 225 33 34 
34 51 225 0 0 0 0 225 225 0 0 0 0 225 49 36 
35 0 0 0 0 0 225 20 23 225 0 0 0 0 0 33 
35 0 0 0 0 0 0 0 0 0 0 0 0 0 0 33 
51 0 0 0 0 0 0 0 0 0 0 0 0 0 0 49 
0 0 0 0 0 0 0 0 0 0 0 0 0 0 0 0 
0 0 0 0 0 0 0 0 0 0 0 0 0 0 0 0 
0 0 0 0 0 0 0 0 0 0 0 0 0 0 0 0 
0 0 0 0 0 0 0 0 0 0 0 0 0 0 0 0 
0 0 0 0 0 0 0 0 0 0 0 0 0 0 0 0 
0 0 0 3 0 0 0 0 0 0 0 0 0 0 0 0 
0 17 18 19 0 0 0 0 0 0 0 0 0 0 0 0 

0 0 0 0 0 0 73 73 73 73 0 0 0 0 0 0 
0 0 0 0 0 0 74 73 57 73 0 0 0 0 0 0 
0 0 0 0 73 73 73 58 0 0 57 73 0 0 0 0 
0 0 0 0 0 0 0 0 0 0 0 0 0 0 0 0 
0 0 0 0 0 0 0 0 0 0 0 0 0 0 0 0 
0 0 0 0 0 0 0 0 0 0 0 0 0 0 0 0 
0 73 42 0 0 0 0 0 0 0 0 0 0 0 73 0 
0 90 90 0 0 0 0 73 73 42 0 0 0 0 57 0 
0 74 73 0 0 0 0 90 74 73 0 0 0 0 0 0 
57 73 42 0 0 0 0 57 73 58 0 0 0 0 0 0 
0 73 58 0 0 0 57 73 73 0 0 0 0 0 0 0 
0 57 73 0 0 0 0 41 74 0 0 0 0 0 0 0 
0 41 58 0 0 0 0 73 73 0 0 0 0 0 0 0 
0 90 0 0 0 0 0 73 90 0 0 0 0 0 0 0 
41 73 0 0 0 0 0 41 73 42 0 0 0 0 0 0 
73 0 0 0 0 0 0 73 73 73 0 0 0 0 0 0 