TILEMAP
16 16 							-- Size of tile map in tiles
32 32 							      -- Tile size & block size
images/celeste.png 	-- Tilesheet
16 32								-- Number of tiles in tilesheet
47 48 0 0 0 30 47 47 47 48 46 47 47 47 31 31 
0 0 0 0 0 68 0 0 0 0 0 0 0 0 46 33 
0 0 0 1 0 0 0 0 0 0 0 0 0 0 0 30 
0 0 0 20 21 22 0 0 0 0 0 0 0 0 0 30 
0 0 0 0 0 0 0 0 0 0 216 216 0 0 0 46 
0 0 0 0 0 0 0 0 0 0 14 16 0 0 0 0 
0 0 0 0 0 0 216 216 0 0 30 32 0 0 0 0 
0 0 0 0 0 0 20 22 0 0 30 32 0 0 0 0 
0 0 0 0 0 0 23 0 0 0 46 31 16 0 0 0 
0 0 0 0 0 0 39 0 0 0 0 46 48 0 0 0 
0 0 0 0 0 0 68 0 0 0 0 0 0 0 0 0 
0 252 2 0 0 0 23 0 0 0 0 0 0 0 0 0 
21 21 21 22 0 0 23 0 0 0 0 3 0 0 251 0 
0 0 23 0 0 0 23 0 0 0 0 20 21 21 21 21 
0 0 23 0 0 0 39 249 0 0 0 0 23 0 0 0 
0 0 23 0 0 0 52 0 0 0 0 0 23 0 0 0 

0 0 0 0 0 0 0 0 0 0 0 0 0 0 0 0 
0 0 0 0 0 0 0 0 0 0 0 0 0 0 0 0 
0 0 0 0 0 0 0 0 0 0 0 0 0 0 0 0 
0 0 0 0 0 0 0 0 0 0 0 0 0 0 0 0 
0 0 0 0 0 0 0 0 0 0 0 0 0 0 0 0 
0 0 0 0 0 0 0 0 0 0 0 0 0 0 0 0 
0 0 0 0 0 0 0 0 0 0 0 0 0 0 0 0 
0 0 0 0 0 0 0 0 0 0 0 0 0 0 0 0 
0 0 0 0 0 0 0 0 0 0 0 0 0 0 0 0 
0 0 0 0 0 0 0 0 0 0 0 0 0 0 0 0 
0 0 0 0 0 0 0 0 0 0 0 0 0 0 0 0 
0 0 0 0 0 0 0 0 0 0 0 0 0 0 0 0 
0 0 0 0 0 0 0 0 0 0 0 0 0 0 0 0 
0 0 0 0 0 0 0 0 0 0 0 0 0 0 0 0 
0 0 0 0 0 0 0 0 0 0 0 0 0 0 0 0 
0 0 0 0 0 0 0 0 0 0 0 0 0 0 0 0 
