TILEMAP
4 4							-- Player position
16 16 							-- Size of tile map in tiles
32 32 							      -- Tile size & block size
images/textures.png 	-- Tilesheet
16 32								-- Number of tiles in tilesheet
50 51 0 0 0 33 50 50 50 51 49 50 50 50 34 34 
0 0 0 0 0 71 0 0 0 0 0 0 0 0 49 36 
0 0 0 1 0 0 0 0 0 0 0 0 0 0 0 33 
0 0 0 20 21 22 0 0 0 0 0 0 0 0 0 33 
0 0 0 0 0 0 0 0 0 0 225 225 0 0 0 49 
0 0 0 0 0 0 0 0 0 0 17 19 0 0 0 0 
0 0 0 0 0 0 225 225 0 0 33 35 0 0 0 0 
0 0 0 0 0 0 20 22 0 0 33 35 0 0 0 0 
0 0 0 0 0 0 23 0 0 0 49 34 19 0 0 0 
0 0 0 0 0 0 39 0 0 0 0 49 51 0 0 0 
0 0 0 0 0 0 71 0 0 0 0 0 0 0 0 0 
0 261 2 0 0 0 23 0 0 0 0 0 0 0 0 0 
21 21 21 22 0 0 23 0 0 0 0 3 0 0 260 0 
0 0 23 0 0 0 23 0 0 0 0 20 21 21 21 21 
0 0 23 0 0 0 39 258 0 0 0 0 23 0 0 0 
0 0 23 0 0 0 55 0 0 0 0 0 23 0 0 0

0 0 0 0 0 0 0 0 0 0 0 0 0 0 0 0 
0 0 0 0 0 0 0 0 0 0 0 0 0 0 0 0 
0 0 0 0 0 0 0 0 0 0 0 0 0 0 0 0 
0 0 0 0 0 0 0 0 0 0 0 0 0 0 0 0 
0 0 0 0 0 0 0 0 0 0 0 0 0 0 0 0 
0 0 0 0 0 0 0 0 0 0 0 0 0 0 0 0 
0 0 0 0 0 0 0 0 0 0 0 0 0 0 0 0 
0 0 0 0 0 0 0 0 0 0 0 0 0 0 0 0 
0 0 0 0 0 0 0 0 0 0 0 0 0 0 0 0 
0 0 0 0 0 0 0 0 0 0 0 0 0 0 0 0 
0 0 0 0 0 0 0 0 0 0 0 0 0 0 0 0 
0 0 0 0 0 0 0 0 0 0 0 0 0 0 0 0 
0 0 0 0 0 0 0 0 0 0 0 0 0 0 0 0 
0 0 0 0 0 0 0 0 0 0 0 0 0 0 0 0 
0 0 0 0 0 0 0 0 0 0 0 0 0 0 0 0 
0 0 0 0 0 0 0 0 0 0 0 0 0 0 0 0 
