TILEMAP
1 14							-- Player position
16 16 							-- Size of tile map in tiles
32 32 							      -- Tile size & block size
images/textures.png 	-- Tilesheet
16 32								-- Number of tiles in tilesheet
35 0 0 0 0 49 50 50 50 34 36 34 34 34 34 34 
35 0 0 0 0 0 0 0 0 49 50 50 50 50 34 34 
35 0 0 0 0 0 0 0 0 0 0 0 0 0 33 36 
35 0 0 0 0 0 0 0 0 0 0 0 0 0 33 34 
35 0 0 0 0 0 273 0 0 0 0 0 0 0 33 34 
35 225 0 0 0 0 274 0 0 0 0 0 0 0 33 34 
34 19 0 0 0 0 0 0 0 0 0 0 0 0 49 50 
34 51 0 0 0 0 0 0 0 0 0 0 0 0 305 0 
51 0 0 0 0 0 0 0 0 0 0 0 0 0 305 0 
0 0 0 0 0 0 0 0 0 0 0 0 0 0 0 0 
0 0 0 0 0 0 0 0 0 0 0 0 0 0 0 0 
0 0 0 0 0 0 0 0 0 0 0 0 0 0 0 0 
0 0 0 0 0 0 0 0 0 0 0 0 145 0 0 0 
8 0 0 0 0 0 0 0 0 0 0 0 305 0 0 0 
24 0 0 0 0 0 305 305 305 0 0 0 0 0 0 0 
18 18 18 19 0 0 0 0 0 0 0 0 0 0 0 0 

0 72 72 72 72 0 0 0 0 0 0 0 0 0 0 0 
0 72 73 72 72 72 56 56 72 0 0 0 0 0 0 0 
0 72 72 72 72 0 0 0 56 72 72 72 0 72 0 0 
0 72 72 72 0 0 0 0 0 72 72 72 72 72 0 0 
0 56 72 72 41 0 0 0 56 72 72 0 72 72 0 0 
0 0 72 89 0 0 0 0 40 72 72 72 72 72 0 0 
0 0 72 72 40 41 0 40 72 72 72 57 0 56 0 0 
0 0 72 72 72 73 0 72 72 72 41 0 0 0 0 0 
0 72 72 72 72 72 40 72 72 72 57 0 0 0 0 0 
72 72 72 73 72 72 72 72 72 72 74 0 0 0 0 0 
56 72 72 72 72 89 72 72 72 72 72 72 0 0 0 0 
0 0 56 72 72 72 72 72 57 72 72 57 0 0 0 40 
0 0 56 72 72 56 57 0 0 72 89 0 0 0 56 72 
0 0 0 72 73 0 0 0 0 56 72 0 0 0 0 72 
0 0 40 72 0 0 0 0 0 40 72 0 0 0 40 72 
0 0 0 0 0 0 0 0 0 72 72 41 0 0 72 73