TILEMAP
1 12							-- Player position
16 16 							-- Size of tile map in tiles
32 32 							      -- Tile size & block size
images/textures.png 	-- Tilesheet
16 32								-- Number of tiles in tilesheet
50 50 50 50 51 0 0 0 49 50 50 50 50 50 50 50 
0 0 0 0 0 0 0 0 0 0 0 0 0 0 0 0 
0 0 0 0 0 0 0 0 0 0 0 0 0 0 0 0 
0 0 0 0 0 17 18 19 0 0 0 0 0 0 0 0 
0 0 241 0 0 49 34 35 23 0 0 0 0 0 0 0 
0 0 0 0 0 0 33 35 0 0 0 0 0 0 0 0 
0 0 0 0 0 0 49 51 0 0 0 0 305 305 0 0 
0 0 0 0 0 0 17 19 0 0 0 0 0 0 0 0 
0 0 0 0 0 0 33 35 0 0 0 0 0 0 0 0 
0 0 0 0 0 0 33 35 0 0 0 305 305 0 0 0 
0 0 0 0 0 0 33 35 0 0 0 0 0 0 0 0 
0 0 0 0 0 0 49 51 0 0 0 0 0 0 305 305 
1 0 0 0 0 0 0 0 0 0 0 0 0 0 0 0 
18 18 18 19 0 0 0 0 0 0 0 0 305 305 0 0 
34 34 34 35 0 0 0 0 305 305 0 0 0 0 0 0 
34 34 36 35 305 305 0 0 0 0 0 0 0 0 0 0 

0 0 0 0 0 0 0 0 0 0 0 0 0 0 0 0 
0 0 0 0 0 0 0 0 0 0 0 0 0 0 0 0 
0 0 0 0 0 0 0 0 0 0 0 0 0 0 0 0 
0 0 0 0 0 0 0 0 0 0 0 0 0 0 0 0 
0 0 0 0 0 0 0 0 0 0 0 0 0 0 0 0 
0 0 0 0 0 0 0 0 0 0 0 0 0 0 0 0 
0 0 0 0 0 0 0 0 0 0 0 0 0 0 0 0 
0 0 0 0 0 0 0 0 0 0 0 0 0 0 0 0 
0 0 0 0 0 0 0 0 0 0 0 0 0 0 0 0 
0 0 0 0 0 0 0 0 0 0 0 0 0 0 0 0 
0 0 0 0 0 0 0 0 0 0 0 0 0 0 0 0 
0 0 0 0 0 0 0 0 0 0 0 0 0 0 0 0 
0 0 0 0 0 0 0 0 0 0 0 0 0 0 0 0 
0 0 0 0 0 0 0 0 0 0 0 0 0 0 0 0 
0 0 0 0 0 0 0 0 0 0 0 0 0 0 0 0 
0 0 0 0 0 0 0 0 0 0 0 0 0 0 0 0 

0