TILEMAP
1 12							-- Player position
16 16 							-- Size of tile map in tiles
32 32 							      -- Tile size & block size
images/textures.png 	-- Tilesheet
16 32								-- Number of tiles in tilesheet
0 0 0 0 0 0 0 0 0 0 0 0 0 0 0 0 
0 0 0 0 0 0 0 0 0 0 0 0 0 0 0 0 
0 0 0 0 0 0 0 0 0 0 0 0 0 0 0 0 
0 0 0 0 0 0 0 0 0 0 0 0 0 0 0 0 
0 0 0 0 0 0 0 0 0 0 0 0 0 0 0 0 
0 0 0 0 0 0 0 0 0 0 0 0 0 0 0 0 
0 0 0 0 0 0 0 196 197 0 0 0 0 0 0 0 
0 0 0 0 0 0 0 17 19 0 0 0 0 0 0 0 
0 0 0 0 0 0 17 34 34 19 0 0 0 0 0 0 
0 0 0 0 0 17 34 36 34 34 19 0 0 0 0 0 
0 0 0 0 0 33 34 34 34 34 35 0 0 0 0 0 
0 0 0 0 0 49 50 34 34 36 35 0 0 0 0 0 
0 0 0 0 3 17 19 33 34 50 51 23 0 0 0 0 
0 0 17 18 18 34 35 49 51 17 18 19 0 0 0 0 
0 0 49 34 34 36 34 18 18 34 34 34 19 0 0 0 
17 18 19 33 34 34 34 34 34 34 34 36 34 18 18 19

0 0 0 0 0 0 72 72 72 72 0 0 0 0 0 0 
0 0 0 0 0 0 73 72 56 72 0 0 0 0 0 0 
0 0 0 0 72 72 72 57 0 0 56 72 0 0 0 0 
0 0 0 0 0 0 0 0 0 0 0 0 0 0 0 0 
0 0 0 0 0 0 0 0 0 0 0 0 0 0 0 0 
0 0 0 0 0 0 0 0 0 0 0 0 0 0 0 0 
0 72 41 0 0 0 0 0 0 0 0 0 0 0 72 0 
0 89 89 0 0 0 0 72 72 41 0 0 0 0 56 0 
0 73 72 0 0 0 0 89 73 72 0 0 0 0 0 0 
56 72 41 0 0 0 0 56 72 57 0 0 0 0 0 0 
0 72 57 0 0 0 56 72 72 0 0 0 0 0 0 0 
0 56 72 0 0 0 0 40 73 0 0 0 0 0 0 0 
0 40 57 0 0 0 0 72 72 0 0 0 0 0 0 0 
0 89 0 0 0 0 0 72 89 0 0 0 0 0 0 0 
40 72 0 0 0 0 0 40 72 41 0 0 0 0 0 0 
72 0 0 0 0 0 0 72 72 72 0 0 0 0 0 0 
