TILEMAP
16 16 							-- Size of tile map in tiles
8 8 							      -- Tile size & block size
images/celeste.png 	-- Tilesheet
13 20								-- Number of tiles in tilesheet
28 28 28 28 30 28 41 42 0 0 0 0 40 28 28 28 
28 30 28 28 28 29 0 0 0 0 0 0 0 27 30 28 
28 28 28 30 28 42 0 0 0 0 0 0 0 40 28 28 
28 41 28 28 29 0 0 0 0 0 0 0 0 0 40 28 
42 0 40 28 42 3 2 0 0 0 0 0 0 0 0 40 
0 0 0 59 14 15 16 0 0 0 0 0 0 0 0 0 
0 196 0 0 27 28 29 183 183 183 183 0 0 0 0 8 
0 0 0 0 40 41 41 18 18 18 19 0 0 0 0 21 
0 0 0 0 0 0 0 0 20 20 0 0 0 0 14 15 
0 0 0 0 0 0 0 0 0 0 0 0 0 0 27 28 
0 0 0 0 0 0 0 0 0 0 0 0 0 0 27 28 
0 0 0 0 0 0 0 183 183 183 183 0 0 0 27 30 
0 0 0 0 0 0 0 17 15 15 19 0 0 0 27 28 
0 213 2 0 0 0 0 0 27 29 0 0 0 0 27 28 
15 15 16 0 0 118 0 0 27 29 0 0 0 118 27 28 
28 30 29 0 0 33 0 0 27 29 0 0 0 14 28 28
