TILEMAP
16 16 							-- Size of tile map in tiles
8 8 							      -- Tile size & block size
images/blocks.png 	-- Tilesheet
10 20								-- Number of tiles in tilesheet
28 28 28 28 28 28 28 28 28 28 29 0 0 0 0 0 
28 28 28 28 28 28 28 28 28 28 29 0 0 0 0 0 
28 28 28 28 28 28 28 28 41 41 42 0 0 0 0 0 
28 28 28 28 28 28 41 42 0 0 0 0 0 0 0 0 
28 28 28 28 28 29 0 0 0 0 0 0 0 0 0 0 
28 28 28 41 41 42 0 0 0 0 0 0 0 0 0 0 
28 28 29 0 0 0 0 0 0 0 0 0 0 0 0 0 
28 28 29 0 0 0 0 0 0 0 0 0 0 0 0 0 
28 28 29 0 0 0 0 0 0 0 0 0 0 0 0 0 
28 28 29 0 0 0 0 0 0 0 0 0 0 0 0 0 
28 28 29 0 0 0 0 0 0 0 0 0 0 0 0 0 
28 28 29 1 2 0 0 0 0 0 0 0 0 0 0 0 
28 28 28 15 15 15 15 15 15 16 0 0 0 0 0 0 
28 28 28 28 28 28 28 28 28 28 16 0 0 0 0 0 
28 28 28 28 28 28 28 41 41 41 42 0 17 18 19 0 
28 28 28 28 41 41 42 0 0 0 0 0 0 0 0 0


