TILEMAP
16 16 							-- Size of tile map in tiles
32 32 							      -- Tile size & block size
images/celeste.png 	-- Tilesheet
13 20								-- Number of tiles in tilesheet
28 28 29 60 60 60 60 27 28 41 41 41 41 28 30 28 
28 30 29 60 61 60 60 40 42 61 60 48 0 40 41 28 
28 28 29 60 60 60 60 20 60 48 47 0 0 0 47 40 
28 28 29 60 48 0 60 20 62 0 0 0 0 0 0 0 
28 28 29 33 0 0 47 20 48 0 0 0 0 0 0 0 
30 28 29 59 0 0 0 48 0 0 0 0 0 0 0 34 
41 41 42 20 0 0 0 0 0 0 0 0 0 33 60 60 
18 18 18 19 183 183 0 0 0 0 0 0 183 46 60 61 
60 60 60 17 19 20 0 0 0 0 0 0 20 46 60 60 
60 61 74 48 47 0 0 0 0 0 0 0 47 59 74 60 
60 60 60 0 0 0 0 0 0 0 0 0 0 47 60 60 
60 48 47 0 0 0 0 0 0 0 0 0 0 0 60 47 
47 0 0 0 0 0 0 0 0 0 0 0 0 47 60 0 
0 0 0 0 0 0 0 0 0 0 0 0 0 0 48 0 
0 33 35 0 0 248 248 0 0 0 248 248 0 0 0 0 
34 46 61 0 0 0 0 0 0 0 0 0 0 0 0 0