TILEMAP
16 16 							-- Size of tile map in tiles
8 8 							      -- Tile size & block size
images/celeste.png 	-- Tilesheet
13 20								-- Number of tiles in tilesheet
41 42 0 0 0 27 41 41 41 42 40 41 41 41 28 28 
0 0 0 0 0 59 0 0 0 0 0 0 0 0 40 30 
0 0 0 1 0 0 0 0 0 0 0 0 0 0 0 27 
0 0 0 17 18 19 0 0 0 0 0 0 0 0 0 27 
0 0 0 0 0 0 0 0 0 0 183 183 0 0 0 40 
0 0 0 0 0 0 0 0 0 0 14 16 0 0 0 0 
0 0 0 0 0 0 183 183 0 0 27 29 0 0 0 0 
0 0 0 0 0 0 17 19 0 0 27 29 0 0 0 0 
0 0 0 0 0 0 20 0 0 0 40 28 16 0 0 0 
0 0 0 0 0 0 33 0 0 0 0 40 42 0 0 0 
0 0 0 0 0 0 59 0 0 0 0 0 0 0 0 0 
0 213 2 0 0 0 20 0 0 0 0 0 0 0 0 0 
18 18 18 19 0 0 20 0 0 0 0 3 0 0 212 0 
0 0 20 0 0 0 20 0 0 0 0 17 18 18 18 18 
0 0 20 0 0 0 33 210 0 0 0 0 20 0 0 0 
0 0 20 0 0 0 46 0 0 0 0 0 20 0 0 0
