TILEMAP
16 16 							-- Size of tile map in tiles
8 8 							      -- Tile size & block size
images/celeste.png 	-- Tilesheet
13 20								-- Number of tiles in tilesheet
16 40 28 28 30 28 28 41 41 41 41 41 42 0 0 27 
28 16 40 41 41 41 42 0 0 0 0 0 0 0 0 27 
28 28 16 20 0 0 0 0 0 0 0 0 0 0 3 27 
41 41 42 0 0 0 0 0 0 0 0 0 2 20 20 27 
16 14 16 0 0 0 0 0 0 0 0 0 17 18 15 28 
29 40 42 0 0 0 0 0 0 0 0 0 0 0 40 28 
28 15 18 18 19 0 0 0 0 0 0 0 0 0 0 27 
28 42 0 0 0 0 0 0 0 0 0 0 0 0 0 27 
29 0 0 0 0 0 0 0 0 0 0 0 0 0 0 27 
42 0 0 0 0 0 0 0 0 0 0 0 0 17 15 28 
0 0 0 0 0 0 0 1 0 0 0 0 0 0 27 28 
0 0 0 0 0 0 0 14 16 0 0 0 0 0 27 28 
0 213 0 14 16 0 0 40 42 0 0 183 183 183 27 28 
15 15 15 28 29 0 0 14 16 183 183 14 15 15 28 28 
28 30 28 28 29 183 183 27 28 15 15 28 28 28 30 28 
28 28 28 28 28 15 15 28 28 28 28 28 28 28 28 28
