TILEMAP
16 16 							-- Size of tile map in tiles
32 32 							      -- Tile size & block size
images/celeste.png 	-- Tilesheet
13 20								-- Number of tiles in tilesheet
28 41 42 0 0 0 27 41 41 41 41 41 41 41 28 28 
29 60 60 0 0 0 46 53 54 60 60 60 60 60 27 28 
42 60 35 0 0 0 59 66 67 0 61 60 0 0 27 28 
60 60 74 48 0 0 0 0 0 0 60 60 0 0 27 30 
60 60 60 0 222 0 0 0 222 0 60 60 60 0 27 28 
60 61 60 0 223 0 0 0 223 0 34 60 0 0 27 28 
60 60 60 35 0 0 0 0 0 34 60 61 0 0 40 41 
60 60 60 60 74 48 0 0 0 47 60 60 62 0 0 60 
60 48 0 0 47 0 0 0 0 0 61 47 48 0 34 60 
60 0 0 0 0 0 0 0 0 0 60 0 0 0 60 60 
61 48 0 0 0 0 0 0 0 34 74 48 0 0 60 61 
48 0 0 0 0 0 0 0 0 0 47 0 0 0 60 48 
0 0 0 0 0 0 183 183 183 0 0 0 0 0 47 34 
183 183 20 183 183 183 14 15 16 0 0 0 118 118 0 47 
15 15 15 15 15 16 27 30 29 183 183 183 20 20 183 183 
28 30 28 28 28 29 27 28 29 14 15 15 15 15 15 15