TILEMAP
16 16 							-- Size of tile map in tiles
8 8 							      -- Tile size & block size
images/celeste.png 	-- Tilesheet
13 20								-- Number of tiles in tilesheet
28 29 27 28 28 29 40 41 41 41 28 29 0 0 0 27 
30 29 40 41 41 42 0 0 0 0 27 29 0 0 0 27 
28 28 16 0 0 0 0 0 0 0 27 29 0 0 0 27 
30 28 29 0 0 0 0 0 0 0 27 42 0 0 0 27 
28 30 29 0 0 0 0 0 0 0 46 0 0 0 0 27 
28 41 42 0 0 0 0 183 0 0 59 0 0 0 0 27 
29 0 3 0 0 0 0 33 0 0 0 0 0 0 1 27 
28 16 20 20 0 0 0 46 0 0 0 0 0 0 14 30 
30 28 15 16 0 0 0 59 0 0 0 0 0 0 40 41 
28 28 30 29 0 0 0 20 0 0 0 0 0 0 14 15 
30 28 28 29 0 0 0 33 0 0 0 0 0 17 41 28 
41 41 28 29 0 0 0 46 0 0 0 0 0 0 0 27 
0 0 40 29 0 0 0 46 0 0 0 0 0 0 0 40 
0 0 0 59 0 0 0 46 183 183 183 0 0 0 0 0 
0 213 0 0 0 0 2 27 15 15 16 0 0 0 0 0 
15 15 15 15 15 15 15 28 28 30 29 0 0 0 0 0
