TILEMAP
16 16 							-- Size of tile map in tiles
8 8 							      -- Tile size & block size
images/celeste.png 	-- Tilesheet
13 20								-- Number of tiles in tilesheet
41 41 41 41 42 0 0 0 40 41 41 41 41 41 41 41 
0 0 0 0 0 0 0 0 0 0 0 0 0 0 0 0 
0 0 0 0 0 0 0 0 0 0 0 0 0 0 0 0 
0 0 0 0 0 14 15 16 0 0 0 0 0 0 0 0 
0 0 196 0 0 40 28 29 20 0 0 0 0 0 0 0 
0 0 0 0 0 0 27 29 0 0 0 0 0 0 0 0 
0 0 0 0 0 0 40 42 0 0 0 0 248 248 0 0 
0 0 0 0 0 0 14 16 0 0 0 0 0 0 0 0 
0 0 0 0 0 0 27 29 0 0 0 0 0 0 0 0 
0 0 0 0 0 0 27 29 0 0 0 248 248 0 0 0 
0 0 0 0 0 0 27 29 0 0 0 0 0 0 0 0 
0 0 0 0 0 0 40 42 0 0 0 0 0 0 248 248 
1 213 0 0 0 0 0 0 0 0 0 0 0 0 0 0 
15 15 15 16 0 0 0 0 0 0 0 0 248 248 0 0 
28 28 28 29 0 0 0 0 248 248 0 0 0 0 0 0 
28 28 30 29 248 248 0 0 0 0 0 0 0 0 0 0
