TILEMAP
16 16 							-- Size of tile map in tiles
32 32 							      -- Tile size & block size
images/celeste.png 	-- Tilesheet
13 20								-- Number of tiles in tilesheet
28 30 28 28 28 29 60 60 60 60 27 28 30 28 28 28 
28 28 30 28 41 42 61 60 47 60 40 41 28 28 30 28 
28 28 41 42 60 60 60 48 0 0 47 60 40 41 28 28 
30 29 183 0 0 0 0 0 0 197 196 197 0 183 27 28 
28 29 183 0 0 0 0 0 0 0 0 0 0 183 27 28 
28 42 183 0 0 0 0 183 183 0 0 0 0 183 40 30 
29 60 35 0 0 0 183 17 19 183 0 0 0 0 60 27 
29 74 74 0 0 0 0 60 60 35 0 0 0 0 47 27 
42 61 60 0 0 0 0 74 61 60 0 0 0 0 0 40 
47 60 35 0 0 0 0 47 60 48 0 0 0 0 0 0 
0 60 48 0 0 0 47 60 60 0 0 0 0 0 0 0 
0 47 60 0 0 0 0 34 61 0 0 0 0 0 0 0 
0 34 48 0 0 0 0 60 60 0 0 0 0 0 0 0 
0 74 0 0 0 0 0 60 74 0 0 0 0 0 0 0 
34 60 0 3 0 0 0 34 60 35 0 0 0 0 0 0 
60 14 15 16 0 0 0 60 60 60 0 0 0 0 0 0