TILEMAP
16 16 							-- Size of tile map in tiles
32 32 							      -- Tile size & block size
images/celeste.png 	-- Tilesheet
13 20								-- Number of tiles in tilesheet
215 215 215 217 215 215 215 215 215 215 215 216 247 247 214 215 
215 215 215 215 215 217 215 215 228 228 228 229 247 247 214 215 
215 215 228 228 228 228 228 229 201 202 202 203 247 247 214 215 
215 216 201 202 203 207 201 203 227 228 228 229 247 247 214 215 
228 229 214 215 216 261 227 229 207 247 247 247 247 248 214 215 
247 247 227 228 229 247 247 235 0 234 0 234 247 247 214 215 
247 247 370 370 370 247 247 0 0 0 0 0 234 201 215 217 
248 247 222 0 0 0 234 235 0 0 0 0 221 227 228 228 
247 247 247 235 0 0 37 0 0 409 221 247 247 247 247 0 
247 235 0 0 0 0 0 0 0 410 234 247 247 247 0 0 
247 0 0 0 222 247 222 0 0 0 0 0 247 247 0 0 
247 0 221 247 247 261 247 0 0 0 0 221 247 235 0 0 
202 202 203 247 247 247 247 247 222 0 0 247 248 247 190 0 
215 215 215 202 202 202 203 247 247 247 247 261 247 247 201 202 
215 217 215 215 215 215 216 234 247 247 201 202 202 202 215 215 
215 215 215 215 217 215 216 0 0 234 214 215 215 215 217 215