TILEMAP
16 16 							-- Size of tile map in tiles
32 32 							      -- Tile size & block size
images/celeste.png 	-- Tilesheet
13 20								-- Number of tiles in tilesheet
29 60 60 60 60 40 41 41 41 28 30 28 28 28 28 28 
29 60 61 60 60 60 47 47 60 40 41 41 41 41 28 28 
29 60 60 60 60 0 0 0 47 60 60 60 0 60 27 30 
29 60 60 60 0 0 0 0 0 60 60 60 60 60 27 28 
29 47 60 60 35 0 222 0 47 60 60 0 60 60 27 28 
29 183 60 74 0 0 223 0 34 60 60 60 60 60 27 28 
28 16 60 60 34 35 0 34 60 60 60 48 0 47 40 41 
28 42 60 60 60 61 0 60 60 60 35 0 0 0 248 0 
42 60 60 60 60 60 34 60 60 60 48 0 0 0 248 0 
60 60 60 61 60 60 60 60 60 60 62 0 0 0 0 0 
47 60 60 60 60 74 60 60 60 60 60 60 0 0 0 0 
0 0 47 60 60 60 60 60 48 60 60 48 0 0 0 34 
0 0 47 60 60 47 48 0 0 60 74 0 118 0 47 60 
8 0 0 60 61 0 0 0 0 47 60 0 248 0 0 60 
21 0 34 60 0 0 248 248 248 34 60 0 0 0 34 60 
15 15 15 16 0 0 0 0 0 60 60 35 0 0 60 61