TILEMAP
16 16 							-- Size of tile map in tiles
32 32 							      -- Tile size & block size
images/celeste.png 	-- Tilesheet
13 20								-- Number of tiles in tilesheet
28 28 28 42 0 0 0 0 0 0 0 0 0 0 0 92 
30 28 29 0 0 0 0 0 0 0 0 0 0 0 0 92 
28 28 29 0 0 0 0 0 0 0 0 0 0 0 0 92 
41 41 42 62 0 0 0 0 0 0 0 0 0 0 79 0 
15 16 60 60 0 0 8 9 10 8 0 0 0 79 93 93 
28 29 61 60 35 0 21 22 23 21 79 80 80 93 106 106 
28 42 60 60 60 35 14 15 15 16 92 93 93 107 0 0 
29 47 60 60 74 60 27 28 28 29 105 106 107 0 0 0 
29 0 48 0 47 60 27 30 28 28 16 0 0 0 0 0 
29 0 0 0 0 14 28 28 28 28 29 0 0 0 0 0 
42 0 0 0 0 40 28 28 28 28 42 0 0 0 0 0 
0 0 0 0 79 80 81 27 28 29 60 35 0 0 0 0 
0 0 0 0 92 93 94 27 30 29 60 60 0 0 0 0 
0 2 0 0 92 93 94 27 28 29 60 74 62 34 35 0 
0 14 15 16 92 93 94 27 28 42 60 60 60 61 48 0 
0 27 28 29 92 93 94 27 29 60 60 60 60 60 60 35