TILEMAP
16 16 							-- Size of tile map in tiles
32 32 							      -- Tile size & block size
images/textures.png 	-- Tilesheet
16 32								-- Number of tiles in tilesheet
34 34 34 51 0 0 0 0 0 0 0 0 0 0 0 113 
36 34 35 0 0 0 0 0 0 0 0 0 0 0 0 113 
34 34 35 0 0 0 0 0 0 0 0 0 0 0 0 113 
50 50 51 0 0 0 0 0 0 0 0 0 0 0 97 0 
18 19 0 0 0 0 8 9 10 8 0 0 0 97 114 114 
34 35 0 0 0 0 24 25 26 24 97 98 98 114 130 130 
34 51 0 0 0 0 17 18 18 19 113 114 114 131 0 0 
35 0 0 0 0 0 33 34 34 35 129 130 131 0 0 0 
35 0 0 0 0 0 33 36 34 34 19 0 0 0 0 0 
35 0 0 0 0 17 34 34 34 34 35 0 0 0 0 0 
51 0 0 0 0 49 34 34 34 34 51 0 0 0 0 0 
0 0 0 0 97 98 99 33 34 35 0 0 0 0 0 0 
0 0 0 0 113 114 115 33 36 35 0 0 0 0 0 0 
0 2 0 0 113 114 115 33 34 35 0 0 0 0 0 0 
0 17 18 19 113 114 115 33 34 51 0 0 0 0 0 0 
0 33 34 35 113 114 115 33 35 0 0 0 0 0 0 0 

0 0 0 0 0 0 0 0 0 0 0 0 0 0 0 0 
0 0 0 0 0 0 0 0 0 0 0 0 0 0 0 0 
0 0 0 0 0 0 0 0 0 0 0 0 0 0 0 0 
0 0 0 74 0 0 0 0 0 0 0 0 0 0 0 0 
0 0 72 72 0 0 0 0 0 0 0 0 0 0 0 0 
0 0 73 72 41 0 0 0 0 0 0 0 0 0 0 0 
0 0 72 72 72 41 0 0 0 0 0 0 0 0 0 0 
0 56 72 72 89 72 0 0 0 0 0 0 0 0 0 0 
0 0 57 0 56 72 0 0 0 0 0 0 0 0 0 0 
0 0 0 0 0 0 0 0 0 0 0 0 0 0 0 0 
0 0 0 0 0 0 0 0 0 0 0 0 0 0 0 0 
0 0 0 0 0 0 0 0 0 0 72 41 0 0 0 0 
0 0 0 0 0 0 0 0 0 0 72 72 0 0 0 0 
0 0 0 0 0 0 0 0 0 0 72 89 74 40 41 0 
0 0 0 0 0 0 0 0 0 0 72 72 72 73 57 0 
0 0 0 0 0 0 0 0 0 72 72 72 72 72 72 41 
