TILEMAP
1 11							-- Player position
16 16 							-- Size of tile map in tiles
32 32 							      -- Tile size & block size
images/textures.png 	-- Tilesheet
16 32								-- Number of tiles in tilesheet
50 51 0 0 0 33 50 50 50 51 49 50 50 50 34 34 
0 0 0 0 0 71 0 0 0 0 0 0 0 0 49 36 
0 0 0 1 0 0 0 0 0 0 0 0 0 0 0 33 
0 0 0 20 21 22 0 0 0 0 0 0 0 0 0 33 
0 0 0 0 0 0 0 0 0 0 225 225 0 0 0 49 
0 0 0 0 0 0 0 0 0 0 17 19 0 0 0 0 
0 0 0 0 0 0 225 225 0 0 33 35 0 0 0 0 
0 0 0 0 0 0 20 22 0 0 33 35 0 0 0 0 
0 0 0 0 0 0 23 0 0 0 49 34 19 0 0 0 
0 0 0 0 0 0 39 0 0 0 0 49 51 0 0 0 
0 0 0 0 0 0 71 0 0 0 0 0 0 0 0 0 
0 0 2 0 0 0 23 0 0 0 0 0 0 0 0 0 
21 21 21 22 0 0 23 0 0 0 0 3 0 0 0 0 
0 0 23 0 0 0 23 0 0 0 0 20 21 21 21 21 
0 0 23 0 0 0 39 0 0 0 0 0 23 0 0 0 
0 0 23 0 0 0 55 0 0 0 0 0 23 0 0 0

0 0 0 0 0 0 0 0 0 0 0 0 0 0 0 0 
0 0 0 0 0 0 0 0 0 0 0 0 0 0 0 0 
0 0 0 0 0 0 0 0 0 0 0 0 0 0 0 0 
0 0 0 74 0 0 0 0 0 0 0 0 0 0 0 0 
0 0 72 72 0 0 0 0 0 0 0 0 0 0 0 0 
0 0 73 72 41 0 0 0 0 0 0 0 0 0 0 0 
0 0 72 72 72 41 0 0 0 0 0 0 0 0 0 0 
0 56 72 72 89 72 0 0 0 0 0 0 0 0 0 0 
0 0 57 0 56 72 0 0 0 0 0 0 0 0 0 0 
0 0 0 0 0 0 0 0 0 0 0 0 0 0 0 0 
0 0 0 0 0 0 0 0 0 0 0 0 0 0 0 0 
0 0 0 0 0 0 0 0 0 0 72 41 0 0 0 0 
0 0 0 0 0 0 0 0 0 0 72 72 0 0 0 0 
0 0 0 0 0 0 0 0 0 0 72 89 74 40 41 0 
0 0 0 0 0 0 0 0 0 0 72 72 72 73 57 0 
0 0 0 0 0 0 0 0 0 72 72 72 72 72 72 41

1
2 1
14 12
7 14